4444444444444444444444444444444444444444444444444444444444444444444444444444444444444444444444444444
4100001110000011111111111100011111110000000111111111111111111111100000011101110001111111100011000014
4110000121200011111111111110001111112000000111112111112111111111000000001111110011111211110111100014
4111000111110111111100111110000121111110000111111111111111111110000000001111111111111111111111110114
4111111111111111110000021110000111111111000012111111111111111100000000011111111111111111111111111114
4111111111111211110000012111000011111111000011111111110111111000000000111111111111111111110111110004
4111111111111111110000011111000011111110000001111111100011111000000000111111111111111111100011110004
4111111111111111100000001111100111111000000000111111100001111000000001111111111111001111100111111114
4001111111111100000000001111112111111000000000011111110001120000000011111111111110000111000111111114
4000011111111000000000000111111111111100000000001111110011100000000011111111111100000000000111111104
4000011013331100000000000011111111111110000000001111110011100000000001111111111100000000000111121004
4000111011111100000000000011111111111110000000011111110011100110000000111111111111110000011111110004
4001111100021100000011120011111111211111000000011111100001121111110001111111111111111000121111100004
4111111110011100001111111111111111211111000000011111100000111111111001111111111111111000111111100004
4111111110011100011111111111110011111110000000011111110000111111111000111111111111121000011111110004
4111111111111000011111111121100001111100000000011111111000011111211101111111111111111100011111110004
4111121000121100021111111111100001111110000000111111111100001111111111111111111111111110011211111004
4101120000011110121111111111100000111111000000111111111110000111111111111121111111111111211111111004
4000000000001111111111111111100000111111000000011100111110000001111111111111211111111111111121111114
4000000000011111211111111111110000011111000000000000011111000001111111111111121111111111100211111114
4000000000111001111111111111111000001111100000000000001111100001111111111111111111111111101111110114
4000000001110000111111111111111000001111110000000000000111110011121111001110111211111111111111100014
4000000001110000001111111111111000001111110000000000000011210112111000001100001111111111001111000004
4111000000111000001121111111112000001121110000001100000011100111111000011100000121111111001110000004
4111110000111100011111111111111100000111110000011110000011100011111100111000000011111111111110000004
4111111111111200011111111111111121000011111000111110000001000001111111110000000000111111111111000004
4111111111111000001111111110001111100011111001111100000000110000111111110011000000111111111111100004
4111111111111000000111111110001111100011111111111000000000111000000111111111110001111111111112111104
4111111111110000000111211111011000110001112111111000000001111100000111111111111001111001211111111114
4111111111110000001111111111110000011001111111111100000011111100000111111001111000211001111111111114
4100001111110000001111111001112000011000111111111110110011111100000011112111111000111111111111111114
4100001111100000001111111001111100111101111111110011111001111100000001111111111101111111111111100114
4110001111110000001111111111111111111111111110000001111100111100000001111111111111001111111111100114
4100000111111000000111111001111111111211211100000000111100011111000000111211111111001111012111111114
4000000011111100000001110000111121111111111110000110001100011111120000111111111111000110001111111114
4000000022111100000000000000001111111111111111101111001000001111111000011111112110000000001111001114
4000000111111110000000000000000111111000111111111111111000001111111000001111110000000000011100001114
4000001111111111100000000000000111110000011111111111111100001121210000001111000000000000111100001214
4000011101111111110000000000001111100000001111111111111100000111111000011111000000000111111111011114
4000011000111111110000000000001111000000001110011111111000000000121100011111100000001121111111111114
4000011001111111111000000000000110000000001110011111111000000000011100011111100000011111100211111114
4100011111111001111111000000000000000000001211001111111000000000011100011111100000011111101111111124
4111111111110000112111100000000000000000000111001111111000000000011000211111110000011111111111111114
4111211111100001111111100000000000011110000011110011111100000000111000121111111000001111111111100004
4111111111100011111111100000000000111111120001111001111110000111111100111111111000000001111111000004
4111111111110111100111111000000011111111111001111101111110001111111100111000110000000000001110000004
4111100111111112100111111100000111110011111101111101121111011111111000111000110000000000000000000004
4111000011001111111111111110000111110011111110111001111111111111111000011101111000000000000000000004
4111100000000111111111111111001111110001121100000000111101111111111000001111111000000000000000000004
4111110000001111111111111111111111111001111000000000111000001111110000000111111100000000000000000014
4112111110011111111111111111111111111111111000000000100000000111000000000011111110000000000000000014
4111111111111112111121111111111111111111111001110011100000001111000000000011111121111111000000000004
4111112111111001111111111110011111111111112111111111110000001111100000000111111111111111211000000004
4111111111110000000111111110001111111111111121111101110000001112111000000110011111111121111100000004
4211111111210000000001111100000011111112111111111000011000011111111200000110011111111111111110000004
4111111111111000000000000000000001111111111111111000011000011111111100000111111111111111111111000004
4111111111111111000000000000000000110021111111111100011000111111111000000011111111111111111111120004
4111001111112111100000000000000001110000011100111100011000111111111000000001111211111111111111111004
4110000111111111110011000000000001111000000000111100011100111111111000000001111111111111111111111104
4111000121111100121111110000000001111000000001111111111111111111111000000011111111111111111111111214
4111100111110000011111111000000000111000011011111111111111111100110000000011111111111111100111111114
4001100011100000011100111000111100110000111111111111111111111000000000111211111112111111100111111114
4001100000000000011100112001111211110000111111111111111111111000000001111111211100110021100111111114
4111110000000000111111110001121111110000011111111121111211111110000001110011111000000001101111121114
4111111000000011111111110001111111210000001111111111111111011111000000110001110000000000011111121114
4111111100000111111111111000111111110000000121111121111000001111000000110011100000000000011111111114
4121111100000111111111111000011111111000000011111111110000000110000001211111011000000000011112111114
4111111000001111111111111000111111111110000011111111110000000000000021111110011100000000011111111114
4111100000011100011100110001111112111111000001111111100000000000000011111110011111000000001111111104
4111000000011100000000000011111111111111100000111111100000000000000001111110011111100000011111111104
4110000000011110000000000000000111111111110000011111110000000000000001111110011112100000011111111114
4000000000001110000000000000000111111111111000011111111000000011100001111100111111100000001111111114
4000000000011111011110000000001111111111111101111111111000000111110001111000111111110000001121111114
4000000000111111111111000000011111111111111111111111111000001111110001111000111111110000000111111114
4000011001111111111111000000011111111110011111111111112000011111110000111111111111110000000111111114
4000111111111121000110000000011111111110001111111111111000011111111001111111111111111100000011111114
4000111111111211000000000000111111111111011111111111111000111111111111111111111111111111110001111004
4000111111111111110000000000111121111111111110011111111000111111111112111111111111111111111001111004
4000011111111111111000000111111111111111111100011211110000111121111111101111111111111111111111211104
4000001111111111111101101111111111111111111000011111110000011111111111000021111111111111111111111114
4000001111111111011111111111111111001111111000001111110000011111111110000011111111111111111112111114
4000021111111110001112211111111111001211110000001111111000001111111100000111111111111111111111111114
4021211111110000000111111122111111111111110000001111111100000111110000000111111111111111111111111114
4111111111100000000011111111111111121111110000001111111110000000000000000111111111111111111110000004
4111111111110000000000111111111111111111110000011111111110000000000000000011011111111111111100000004
4111111111111000000000111111121111111001111000111111111200000000011000000000001111111111110000000004
4000111111111000000000111111111111111001111100111111111100000000111200011000000111111111100000000004
4000111111001100000000012111110000111001111100111111111000000001111110111100000000111111000000000004
4000011110000110000000001111100000110000111000011111100000000001111111121110000000121111000000000004
4110000111000011000000001121000000110000010000000111000000000001121111111121000000111110000000000004
4111000011000011100001111111000000100000001000000011000000000000111111111111000001111111000000000004
4111100000101121100011211111100001100000111100000001100000000001111211111210000011111111000001100004
4111110001111111100011110011110001111001111100000011110000000011111111111110000021111111111111110004
4011111112111111110011100000011111111111111100000011111000000111111111111110000011111111111111211004
4011111111111111121121110000021111111211111100000001111000000111111111112110000111111111111111111104
4111111111111121111111111100011111111112111110000000110000111111110011111110000111111111111111111114
4111111111111111111001111110011111111111111111000000000002111111100011111110001111110011111111111114
4111111111111111110000111121111111111111111111000000000001111111000001111111111111100011111111121114
4111111111111111100001111111111121111111111111000000000000100011000000111111111111110111111111111104
4444444444444444444444444444444444444444444444444444444444444444444444444444444444444444444444444444
