4444444444444444444444444444444444444444444444444444444444444444444444444444444444444444444444444444
4111114111111412111111111111111111141111111111000001111111111111111110000001000001111111001111111144
4111111111111111111111111111111111111111111111000011111111111111111111110011100011211111111111111114
4111111111112114111211111111111111111411211111110211111111411211111111111111100111111111111111111414
4111111111111111111114111111121111111111111111111111411111111111111111111111111111111111111111114114
4111121111111111112111111110111111111121114111111111111111111111111111111111111111121111111111111114
4114111111121111111111111100011111111111111142111100001111111111100111111111111111111111111111111114
4111111111221121114111114210001111111211100111111100000011111121100011111111111111211111111111111114
4211111111111111111111111111011112111111100111111111100001111111110001111111111111111111111211211114
4111111111111211110011111111111111411111111111111111111011111111111000111111111011111111211111111114
4111111111111111110011111111001141111111111141111111111112111112111000011211110001111111112111111214
4111111111111111111111111111001121111111111111111111111111111111110000111111110000111111000111111114
4111100111111111111111111111111111111111111111111111100011111111100001111111110001111111000011111114
4111100111111141111111111111111111211111112111111100000001111111100011211111100001111111000011112114
4111100211111111111141121111111111110110111111121100000000111111110021121111100000111111100111111114
4111111111111111111111111111111111100000001111111000000000011111111111111111000001111111111112212114
4111111111111111111111111111111111100000000111100000000000001111111111110011000001121111111111111144
4111111111111111111112111111112111100000002111100001101110000111111111100011000001111112111111111114
4111111111111111111111111111111111000011011111111111111111000111211111110111100001111111111111111114
4111111111111111111111111111111111000111111111111111111111111111111111111111114111111111110012111114
4111111111111111111111111111111111111111112111111111111111111111111111111111111111111111110001410004
4111111111111111111111111121111111111111111111111111111111111111111111111111111111111111111001110004
4112111111111100011111141111111111111111111111111111111111111111111111411111111110011111112111111104
4111111111111100001111111111111111111111112112121111111141111111141111111111111110011111111111111114
4111111111112100000111100111111111111111111111111112111114111111111111111411111111111111111111111114
4001111114111110002112100111000011111111111111111111111411111111111111111111114112111111111111111114
4000111111111110002111100111000011111111111111111111111221111111111111111111111121111111111111111214
4000211111111110000111100011111111111211111111111111111111111111111111114111111111111111111111111114
4000111111111114100111110011111112111111111111111111111111120011111111214111111111111111111111114114
4000011111111111111141211111111111111111111111100122111211100011111111112112111211111111112111111214
4100011111111111111111111111111111111111111111000211111121000011111111111111111411111112111111111114
4110111111111110011111441111111111111111111111101111111210000011111111110011111111111111111111111114
4111111111111110011111111111111111111111111114111211111110000111111211110011112111111111111111111114
4111111111111111111111111111111111111111111111111111111111111111111111241011111111111111111111111114
4111121111112111111111111211111111111111111114111111111121111111121111111111441111111111111111121114
4114111111111111111111111111111111111112111211114121111111211111211111211112111111111111124111111114
4111111100000111111111111111111111111112111110011111211111111111111111111111111114111111111111111114
4111111000000111111111111111111111111111111110001111111111111141111111111411100011121111111211111114
4111111100000011111111111111111011111100012100001411111111111111111112111141100000111121121111111004
4011111110000001111111111111100001110000000011111111111111111111111111144111110000011100111111110004
4001111110000011111111111111100011100000000011111111111111411111111111111111111000000000021111110004
4001111410000111111111111111111112100001100111111441111111111111111100111111111100000000001111110004
4111111110000111111111114111111111211111111111111111111111111112111100011111111110001100001111110004
4141110000000114111111211111411111111111112111111111111111111111111110011111211111111110011111110004
4111100000000111111111111111111111111211111111111111111111111111114111111111111111111110011111211004
4111100001211111111111111141111111411111121111111111111111111111111112110011111111111111111111111004
4111100011111111111111111111111112111111111111114111114212111211111111110011111111111111111111111004
4111120011111111111111111111111111111211111111111111111141111111111111111141111111111111111121111004
4111111111111111111111111111101211111121111110011121111114111411111111111111111111111111111111111104
4111111111114114111114111111000011111111211100011111111111111112111121111111111111111111111114111114
4111111111111111111111111111000001111101111100001111011111111111111111111111111111112110001111111114
4001111111111111111111111111100000111100111110011110001111111111111121111111111111111100001111111114
4000111111111111111111111111110000011100211111111100000111111111111111111111111111100110000111111114
4000011111111111111111121111111000001111111111111110000001111111111111111111111111100110000001112214
4000011111111111111111141411111410001111111112111111000000111111111111111111111112111410000000111114
4000111111111111111121111211111111111111111111111111000000011121111111111111111111111111000000111114
4000211111111111111111411111111111121111111111411111000000011111111110011111111112211111000001111114
4001111411111114111111111111111111121111110111112111000000011111121110011111111111111111100001111114
4111111111111111111111111111111111111122100011121111100000011111111211111111111111111114100000111114
4111112111111111111114111111111111111111110011111111110000011111111111111111111111111111100000001114
4111111111111111141111111111111111111111111111111111110000001111111111110011111111111111110000001114
4111111111141111111111111111111111111111111111111111111110001111121111110011111111111111140000001114
4111111111211111111111141114121111112111111111111111111111001111111111112111111111111111111012112114
4110011111111111111111111111111111111111111111111111211211111111111111111111111111111111111111211114
4110011111111111211111111114414111111111111111111111111111111111111111111111111111111111111111111114
4111111111111111111111111111111111111111111111111112111111111100111112141111111111111111111111100114
4111111111111111111112111111111111111111111111111111111111001100111412211111111111111111111111000014
4111111111111111111111111111111111111111111111411111110011001111111111111111121111111111111112000004
4112111111111111111111111111111111111111111111111111110011111111111111111111411110111111001111200004
4111111411111111111111411111121111111111111111111141111411441121112111112111111100011111001112110004
4111111111111111121211111111111111111111111121111111111111121111111111111111111000011111111111111004
4111111111111111111111101111111111111111121111111121111111111111111111111111210000011111211111111104
4111111111111111111111000114111111111111111001211111111111111111111111111111111000001111111101111104
4111111111112112111111000114111111111111110001111111111111111111111111111111111100001111111000121114
4111111111111111111111000121111114111121110011111111111111111111111111111111111110001111111000011114
4111111111111111111111000111111111111111112111111111111111111111111111111141111111000111111000001114
4211111111111111111111111111111211111111121121111111111110114111411111111211111111001111111000011414
4001111111111211111111111111111111111111121111111111111100011101111111111111211111111411111000111114
4000111111111111111111111111111111111111111111111111111410001111111111111111121111111111111411110114
4001111411111114111111111111121111111112111111111111111114111111111111111111111111111411111111100014
4111111411111112111111111111111111211111111411111111111111111111111121111111001111111111111111000014
4114111121111110111111111111111000111111111111111111111111111211111111111111001111111001111111000024
4111411111111100014114111112211000011111111111111111111111111111112111111111111111121001111110000014
4111111111111110111114111111111000011111111111111111111111211111111111111111111121111411111000000014
4411121111111121111111111111111000011121111111111111121111111111111111111111111111111111110000000004
4111111111211111001211111111110000111111111111111111111111211111111111110000001111141111110000000014
4111111111111111001111111111111000111111111111111111111111111111114112110000001111111111111000111114
4112111111111111111111114111111000211111111111111411111111111111111111111110001111111111111101111114
4111111211111111111111111111111111111111111111411111111121111141111111111111011110111121111111111114
4111241112111111111111111111111111111111111111111111001111111111111111112111141100011111111112100114
4111111111111111111111111111111111111111111111111112000111111111111111111111111100111111411211000014
4111111111111111111110111111111121111001111111111011100111111111111112211111111111111111111110000114
4111111111111111111100011211111111110001111111111111100111111111112111112111111111111111111110000144
4411111110111111411100011111111111110001211111111111111111211111111111121100111111111111111111110114
4211111100011111111110141111111111110001111111111111111111111111111111111100111211112111111111121004
4111112100111111111111111111211111111001111111111111111111111111111111111101111111111111111212112114
4111121111111411111111111111111211111001111111111111211111211111121111111011111111001111114111211114
4111111111111121111111111121111111111111111111111001110011111111111111000001111111000111111111121114
4111111111114111111111111111111111111111411111110000100011111111111110000011111111000111111111111114
4444444444444444444444444444444444444444444444444444444444444444444444444444444444444444444444444444